1  1  1  1  1  1  1  1  1  1  1  1  1  1  1
1  0  0  0  9  &  1  0  2  0  &  9  &  0  1
1  0  0  0  0  0  0  0  9  0  0  0  0  0  1
1  0  0  0  0  0  0  0  0  0  0  0  0  0  1
1  0  0  0  0  0  0  0  1  0  0  0  0  8  1
1  0  0  0  0  0  0  &  2  9  0  0  0  0  1
1  0  0  0  &  2  0  0  0  0  0  0  0  0  1
1  3  0  0  0  0  0  0  0  0  0  0  0  0  1
1  0  0  0  0  0  0  0  0  0  0  0  0  0  1
1  0  0  0  0  0  0  0  0  5  0  0  0  0  1
1  0  0  0  0  0  0  0  0  0  0  0  0  0  1
1  0  0  0  0  0  0  0  0  0  0  0  0  0  1
1  0  0  0  0  0  0  0  0  0  0  0  0  8  1
1  1  0  0  5  0  0  0  0  0  0  0  0  2  1
1  1  1  1  1  1  1  1  1  1  1  1  1  1  1
