1  1  1  1  1  1  1  1  1  1  1  1  1  1  1
1  3  1  0  0  6  0  0  0  0  0  7  0  0  1
1  0  1  0  1  0  0  0  0  0  0  0  0  8  1
1  0  0  4  6  4  0  7  7  0  0  4  0  0  1
1  1  1  7  1  0  0  0  0  0  0  0  0  0  1
1  0  0  0  1  0  0  0  0  0  0  0  0  0  1
1  0  1  0  1  1  0  0  0  0  0  0  0  0  1
1  0  0  6  2  7  1  0  0  0  0  6  2  0  1
1  0  1  5  0  7  1  2  0  0  0  7  0  0  1
1  0  1  5  1  7  0  8  0  0  0  0  0  0  1
1  0  1  5  8  8  1  0  0  0  0  0  0  0  1
1  0  0  1  0  1  0  0  0  6  0  4  0  0  1
1  4  0  0  0  0  0  0  0  0  1  2  1  2  1
1  0  0  0  0  0  0  0  0  1  1  1  1  5  1
1  1  1  1  1  1  1  1  1  1  1  1  1  1  1
