1  1  1  1  1  1  1  1  1  1  1  1  1  1  1
1  7  8  0  0  0  0  0  7  8  7  0  8  0  1
1  0  5  0  0  0  8  7  8  5  8  1  5  8  1
1  0  1  7  0  0  0  0  0  0  0  8  6  5  1
1  0  0  0  0  0  0  6  7  0  0  0  5  8  1
1  6  0  0  0  0  0  0  0  0  0  0  0  5  1
1  0  0  0  0  0  0  2  6  7  0  0  0  0  1
1  0  0  0  0  0  0  0  7  8  0  0  0  0  1
1  6  0  0  7  0  0  5  8  0  0  0  0  0  1
1  0  7  8  6  7  0  0  1  0  0  0  0  0  1
1  5  8  1  7  8  0  0  1  0  0  0  0  0  1
1  6  0  0  0  7  0  0  0  0  0  0  0  0  1
1  5  0  0  8  0  0  0  0  0  0  3  1  0  1
1  0  0  0  0  6  5  0  0  0  0  0  0  0  1
1  1  1  1  1  1  1  1  1  1  1  1  1  1  1
